p.1
dwell on|~에 거주하다,~에 생각이 머무르다,~을 곰곰히 생각하다
ideally|이상적으로
executor|집행자
unfold|전개되다
simulate|모의 실험하다
astonishingly|놀랍도록
protein-folding|단백질 접힘
superconductivity|초전도
unknowingly|자신도 모르게
withhold|받지 않다,억제하다
undermine|(사람의 평판을)깍아 내리다,훼손하다
credit|명성,신용
ego|자아
secondary|부차적인
smoothly|순조롭게
obstacle|방해,방해물,장애,장애물
unconscious|무의식적인
resentment|분개
attract|끌어들이다
pause|멈추다
refresh|원기를 회복하다
mentally|정신적으로
get caught in|~에 사로잡히다
apply|적용하다
exhale|(숨을)내쉬다
sentiment|감정,정서
fall away|서서히 사라지다
manufacture|제조하다
compound|혼합물
defense|방어 수단
microbe|세균,미생물
deter|저지하다
pest|해충
predator|포식자
reproduce|번식하다
combat|결투
attract|끌어들이다

p.2
pollinator|꽃가루 매개자
evolve|진화시키다
intoxicating|취하게 하는
scent|향기
nectar|꿀,화밀,과즙
pheromone|페로몬,유인 물질
dazzling|놀라운,눈부신
in contact with|~와 접촉하는
conduction|(전기나 열의)전도
given|~을 고려해 보면
random|일정치 않은,임의의
molecule|분자
boundary|경계,경계선
deficit|결손,부족,부족량
substantial|상당한
temperature|온도,기온
heat conductor|열전도체
take place|일어나다,발생하다
surface|지표면,표면
overnight|하룻밤 동안의
Mediterranean|지중해의
allotment|배분,할당
literacy|읽고 쓰는 능력
selection|선택
utilize|활용하다
track|추적하다
fitness|적응도
measure|측정하다,판단하다,평가하다
birth rate|출생률
inclusive fitness|포괄 적응도
flourish|번영하다
initially|처음에,시초에
advertiser|광고주
commercial|광고 방송의,광고,광고 방송
reach|(마음을)움직이다,(남의)환심을 사다
nurture|키우다
enduring|지속적인
attachment|애착
feature|주연시키다
sponsor|후원하다
feature film|장편 영화

p.3
steer|방향을 돌리다
gorgeous|멋진,화려한
cost a fortune|많은 돈이 들다
craftsmanship|(훌륭한)솜씨,장인의 기능
bet|(선택해야 할)방책