p.404
transport|운송하다,이동시키다,운송,운송 수단,이동
transportation|운송,수송,수송 수단
transit|운송,수송,통과,통행
transition|(다른 상태로의)이행,변화
compartment|(기차 등의)객실,칸,칸막이
cargo|(선박.비행기의)화물
freight|화물,화물 운송,화물로 보내다

p.405
overload|과적하다,짐을 너무 많이 싣다,부담 주다,과적,너무 많은 짐
fare|(교통)요금,운임
pedestrian|보행자,보행자의
crossroads|교차로,네거리,(중요한)갈림길,기로
crosswalk|횡단보도
junction|교차로
alley|골목길,오솔길
verge|도로변,길가,가장자리,경계,한계,직전
on the verge of|~하기 직전의

p.406
pavement|포장도로,인도,보도
ramp|(높이가 다른 두 도로.건물 등의 사이를 연결하는)경사로,진입로,램프
pave|(길을)포장하다
lane|차선,좁은 길
highway|고속도로,(시내와 연결된)간선도로
freeway|고속도로
superhighway|(여러 차선의)고속도로
toll|통행료,(전쟁.재난 등의)사상자 수,희생자 수,(요금을)징수하다,(종이)울리다
congestion|혼잡,정체
congested|혼잡한,붐비는

p.407
stuck|(~에 빠져)움직일 수 없는,꼼짝 못하는
horn|(차량의)경적,(동물의)뿔
bypass|우회하다,우회 도로
tow|견인하다,끌다,견인
raft|뗏목,고무보트,뗏목을 타다
rafting|래프팅,뗏목 타기
paddle|(고정되지 않은 짧은)노,노를 젓다

p.408
shipping|선박,배,해상 운송
shipment|수송,선적,선적량
vessel|(대형)선박,배,그릇,융기,혈관,맥관
deck|갑판
harbor/harbour|항구,피난처,항구에 정박하다,(생각을)품다,숨겨주다
port|항구,항구 도시,항만
dock|선착장,부두,(배를)부두에 대다

p.409
anchor|닻,(뉴스)앵커,아나운서,닻을 내리다,고정시키다
embark|(배에)승선하다,짐을 싣다,착수하다,시작하다
canal|운하,수로
steer|(탈것을)조종하다,나아가다,(사람이나 상황을)인도하다,이끌다
navigate|항해하다,(탈것을)조종하다,(지도 등을 보고)길을 찾다,방향을 읽다
navigation|항해,운항
navigator|항해사,조종사

p.410
wreck|난파,난파선,조난,난파시키다
aviation|비행,항공
aviator|비행사
aircraft|항공기
runway|활주로,(패션쇼장의)무대
crew|승무원,선원,(함께 일을 하는)팀,반,조

p.411
board|판자,판,게시판,(숙박업소 등의)식사,하숙하다,(비행기.배 등에)탑승하다,위원회,이사회
even|평평한,반반한,균등한,일정한,대등한,피장파장인,짝수의,차분한
evenly|평평하게,균등하게,일정하게,차분히