p.412
chore|(정기적으로 하는)일,허드렛일,하기 싫은 지루한 일
errand|심부름,잡일
vacuum|진공,진공청소기,진공청소기로 청소하다
detergent|세제,세정제
lawn|잔디,잔디밭
mow|(풀을)베다
mower|잔디 깍는 기계
sweep|청소하다,쓸다
utensil|(특히 가정용)기구,도구
gear|톱니바퀴,기어,(특정 활동을 위한)장비,의복,맞게 하다,조정하다
gear up for|~을 위한 준비를 하다

p.413
textile|직물,옷감,직물의,방직의
weave|(옷감 등을)짜다,엮다
garment|옷,의류
clothing|의류
apparel|(좋은)의류,의복
outfit|(특별한 경우.목적의)복장,옷,장비
attire|차림새,복장
wrinkle|주름,주름지다,주름을 잡다,(얼굴 등을)찡그리다
stain|얼룩,때,오점,얼룩지게 하다
stainless|얼룩이 없는,녹이 슬지 않는
ragged|낡아빠진,남루한,(표면 등이)고르지 못한
rag|넝마,누더기

p.414
ornament|장식,장식품,장식하다
ornamental|장식용의
cosmetic(s)|화장품,미용의,성형의,표면적인,겉치레에 불과한
appetite|식욕,욕구,욕망
appetizer|(식전에 먹는)식용을 돋우는 음식,애피타이저
fease|축제,잔치
banquet|연회,만찬
beverage|(물이 아닌)음료,마실 것
edible|먹을 수 있는,식용의

p.415
dine|식사하다,만찬을 들다
dine out|외식하다
dine in|집에서 식사하다
cuisine|(주로 비싼 식당의)요리,요리법
devour|게걸스레 먹다,집어 삼키다,(엄청난 관심과 열의로)탐독하다,뚫어지게 보다
lick|핥아먹다,핥다
suck|빨아내다,빨아 먹다,빨아 마시다
reside|거주하다,살다
resident|주민,거주자,레지던트,전문의 실습생,거주하는
residential|주거의,거주지의
residence|거주,거주지
dwell|거주하다,살다,(어떤 상태에)머무르다,못 떠나다
dwell on|곰곰이 생각하다,곰곰이 곱씹다
dweller|거주자
dwelling|거주지

p.416
inhabit|거주하다,살다,서식하다
inhabitant|주민,거주자,서식 동물
sedentary|(활동 등이)주로 앉아서 하는,한 곳에 머물러 사는
estate|사유지,토지,자산,재산
real estate|부동산
erect|건설하다,(똑바로)세우다,똑바로 선
erection|건립,설치
blueprint|(건물.기계 설계용)청사진
framework|(건물 등의)뼈대,틀
pillar|기둥,기둥 모양의 것
column|(둥근 석조)기둥,원주,(둥근 기둥 모양의)기념비,(신문.잡지 등의)정기 기고란
insulate|절연 처리를 하다,방음 처리를 하다
ventilate|환기하다
ventilation|통풍,환기,환기 장치

p.417
furnish|(가구 등을)비치하다,제공하다,공급하다
renovation|(낡고 오래된 것의)수리,혁신
renovate|수리하다,보수하다,새롭게 하다
shelter|피신처,보호소,보호하다
lease|임대차 계약,임대하다,임차하다
rent|집세,임대료,임차료,임대하다,임차하다
tenant|세입자,임차인
landlord|집주인,임대주
spacious|(공간.방이)넓은,훤히 트인

p.418
cozy|아늑한,안락한
housewarming|집들이
bound|묶인,(~할)의무가 있는,반드시 ~하게 되어 있는,뛰다,(공 등이)튀어 오르다,도약,인접하다,경계를 짓다,경계,한계,범위,~로 향하는,~행의
bound for|~로 향하는,~행의
boundless|무한한,끝없는

p.419
serve|(식당 등에서)음식을 제공하다,상에 차려주다,도움이 되다,기여하다,(필요로 하는 것을)제공하다,(특정 용도로)쓰일 수 있다,적합하다,일하다,복무하다,(교도소에서)복역하다,(테니스 등에서)서브를 넣다
attend|주의를 기울이다,신경을 쓰다,간호하다,돌보다,가다,참석하다
pay attention to|~에 주의를 기울이다
attention|주의,주목,관심,보살핌,돌봄
attendance|출석,참석
attendant|참석자,종업원,안내원,수행원
attentive|주의 깊은,세심한