p.350
province|주,도,(수도 외의)지방
county|(영국.미국 등의)자치주,군
district|지역,구역
metropolitan|대도시의,수도의
cosmopolitan|전 세계적인
metropolis|대도시,수도
suburban|교외의,교외에 사는
suburb|교외,도시 주변 주택 지역

p.351
infrastructure|사회 기반시설,공공 기반시설
facility|시설,편의 시설,특성,기능,(타고난)재능
endow|기부하다,(재능 등을)부여하다
be endowed with|~을 타고나다,~을 지니다
wellbeing|복지,안녕
pension|연금,생활보조금

p.352
insure|보험에 들다,보장하다
insurance|보험,보험료
hierarchy|계급,계급 제도,계층
imperial|황제의,제국의
imperialism|제국주의
lord|(높은 신분의 남자)귀족,경,(중세 유럽의)영주,하느님,주님

p.353
slave|노예
slavery|노예 신분,노예 제도
empire|제국
emperor|황제
aristocracy|귀족,귀족 계층
aristocrat|귀족
royal|국왕의,여왕의
royalty|왕족
nobleman|상류층 사람,귀족
majesty|폐하,왕권,장엄함
majestic|장엄한
knight|(중세의)기사
civic|시민의,공민의,도시의,시의
cluster|무리,떼,(작은 열매의)송이,무리를 이루다,모이다
turmoil|소란,혼란

p.354
overpopulation|인구 과잉
abuse|학대,남용,오용,학대하다,남용하다,오용하다
abusive|모욕적인,폭력적인
minority|소수,소수 집단,소수의,소수자의
minor|작은,중요하지 않은,부전공의,부전공,미성년자
orphan|고아,고아로 만들다
orphanage|고아원

p.355
bully|괴롭히다,따돌리다,괴롭히는 사람
outcast|따돌림받는 사람,버림받는 사람
bullying|괴롭히기,집단 따돌림
addict|중독자,중독시키다
addicted to|~에 중독된
addiction|중독
addicted|중독된
addictive|중독성의
exploit|(부당하게)이용하다,착취하다,(최대한)활용하다,개발하다
exploitation|(부당한)이용,착취,개발
discriminate|차별하다,구별하다,식별하다
discrimination|차별,식별,식별력,안목

p.356
segregate|차별하다,분리하다
segregation|차별,차별 정책,분리
constrain|강요하다,억지로 시키다,제한하다,제약하다
constraint|제한,제약
suicide|자살
commit suicide|자살하다
impoverish|빈곤하게 하다,가난하게 하다,품질을 저하시키다
underprivileged|(사회.경제적으로)혜택을 못 받는

p.357
needy|(경제적으로)어려운,궁핍한
famine|기근,굶주림
starvation|기아,굶주림
starve|굶주리다,굶어죽다
plight|역경,곤경
tackle|(문제 등을)다루다,(힘든 상황 등과)씨름하다,태클하다,공을 뺏다,태클
eradicate|없애다,근절하다

p.358
subsidy|(국가 등이 제공하는)보조금,장려금
subsidize|보조금을 주다
harmonize|조화를 이루다,조화시키다
harmonious|조화로운
strike|(손이나 무기로)치다,공격하다,충돌하다,부딪히다,파업,파업하다,떠오르다,생각나다,발생하다,덮치다
strikingly|눈에 띄게,두드러지게

p.359
stake|말뚝,지분,이해관계,(내기.도박 등에)건 돈,(돈 등을)걸다
at stake|위기에 처한,위태로운