p.386
offense/offence|범죄,범법,불쾌하게 하는 것,공격,공격법
offend|불쾌하게 하다,(도덕 등에)어긋나다,위반하다
offender|범죄자
offensive|불쾌한
wrongdoing|범법 행위,부정 행위,비행
fraud|사기,사기꾼,속임
villain|(연극.이야기 등의)악역,나쁜 사람,악인

p.387
bribe|뇌물,뇌물을 주다,매수하다
bribery|뇌물 수수,뇌물을 받음
rob|도둑질하다,강탈하다
rob A of B|A에게서 B를 빼앗아가다
robbery|강도질,도둑질
robber|강도
pickpocket|소매치기
burglary|주거 침입 강도
shoplifting|가게 좀도둑질
pirate|해적,저작권 침해자,표절자,표절하다,저작권을 침해하다
forge|위조하다,날조하다,꾸며내다,만들어내다,구축하다

p.388
falsify|(문서 등을)위조하다,조작하다
fabricate|(거짓 정보를)날조하다,조작하다,만들다,조립하다
fabrication|꾸며낸 것,위조,위조물,제조,조립
menace|위협,협박,위협하다
hostage|인질,볼모
trespass|무단침입,무단침입하다
kidnap|유괴하다,납치하다
gamble|도박,도박을 하다
hijack|(차량.비행기 등을)납치하다
murder|살인,살인죄,살해하다
blackmail|갈취,갈취하다,공갈,공갈하다

p.389
confederate|공범,공모자,동맹국,연합국,동맹하다,동맹의,연합한
sue|고소하다,소송을 제기하다
lawsuit|소송,고소
defendant|피고
attorney|변호사,(특히 법률문제의)대리인

p.390
petition|(법원에 법률적 처리를 요청하는)청원,청원서,탄원,탄원서,청원하다,탄원하다
patrol|순찰,순찰대,순찰을 돌다
cop|경찰관
apprehend|체포하다,이해하다,파악하다
summon|소환하다,호출하다
summons|소환,소환장,호출
scrutiny|정밀 조사,철저한 검토

p.391
surveillance|(용의자.죄수의)감시
interrogate|심문하다,질문하다
torture|고문,심한 고통,고문하다,괴롭히다
torturous|고문의,고통스러운
confess|(죄.잘못을)자백하다,인정하다,고백하다
confession|자백,인정,고백
prosecute|기소하다,공소를 제기하다
prosecutor|검사

p.392
plead|(피고가 재판에서 자신의 유무죄를)주장하다,변호하다,애원하다,간청하다
plea|주장,변호,애원,간청
testify|(법정에서)증언하다,진술하다,증명하다
testimony|증언,증명
jury|배심원,배심원단,심사위원단
juror|(한 사람의)배심원
verdict|(배심원단의)평결,의견,결정
innocence|무죄,결백,순진,천진난만
innocent|무죄인,결백한,순진한,천진난만한

p.393
convict|유죄를 선고하다,유죄를 입증하다
conviction|유죄 선고,유죄 판결,확신,신념
punishment|처벌,벌
capital punishment|사형
punish|처벌하다,벌주다
penalty|형벌,처벌,벌금,불이익
pay the penalty (for)|(~에 대한)대가를 치르다
penalize|처벌하다,벌칙을 적용하다,불리하게 하다
imprison|투옥하다,감금하다
amnesty|사면,사면하다,특별 사면
imprisonment|투옥,감금

p.394
commit|(범죄 등을)저지르다,약속하다,전념하다,헌신하다
commit oneself to|~를 약속하다,~에 전념하다,~에 헌신하다
commit A to memory|A를 마음에 새기다,암기하다
commitment|약속,전념,헌신,의무,책임
attribute|(~의)탓으로 보다,(~의)덕으로 보다,(~의)것이라고 하다,(성질 등의)있다고 생각하다,속성,자질
attribute A to B|A를 B의 탓으로 보다,A를 B의 덕으로 보다

p.395
resolve|분해하다,(문제 등을)풀다,해결하다,결심하다,결의하다,결심,결의
resolution|해결,결심,결의
release|석방하다,석방,발매하다,개봉하다,발매,개봉,방출하다,내뿜다,방출