p.468
infamous|악명 높은
notorious|악명 높은
cynical|냉소적인,빈정대는
skeptical|회의적인,의심 많은
reluctant|꺼리는,마음 내키지 않는
be reluctant to-v|v하기를 꺼리다
reluctance|꺼림,마음 내키지 않음
rigid|융통성 없는,완고한,뻣뻣한,단단한

p.469
stern|매우 엄한,엄격한,근엄한,심각한
immature|미숙한,다 자라지 못한
naive|(경험.지식 부족으로)순진한,세상을 모르는
clumsy|어설픈,서투른
haste|서두름,급함,성급
in haste|서둘러서,성급하게
hasty|서두르는,급한
hasten|서두르다,재촉하다
reckless|무모한,신중하지 못한

p.470
arrogant|거만한,오만한
arrogance|거만,오만
outspoken|노골적으로 말하는,거침없이 말하는
arbitrary|(행동.결정 등이)임의의,제멋대로인,독단적인
arbitrarily|임의로,제멋대로
overbearing|강압적인,남을 지배하려 드는
nasty|못된,심술궃은,더러운,불쾌한
naughty|버릇없는,못된
insolent|무례한,거만한
crafty|교활한,간사한
cunning|교활한,약삭빠른
sly|교활한,음흉한

p.471
wicked|사악한,못된,짓궃은,장난기 있는
mischief|(특히 아이들의)장난,못된 짓
mischievous|짓궃은,장난이 심한
tease|놀리다,장난하다,짓궃게 괴롭히다
mock|조롱하다,놀리다
sneer|냉소하다,비웃다
mockery|조롱,놀림
humiliate|굴욕감을 느끼게 하다,창피를 주다
humiliation|굴욕,창피

p.472
immoral|부도덕한,비도덕적인
immorality|부도덕,비도덕성
deviant|일탈적인,정상에서 벗어난
despise|경멸하다,멸시하다
contempt|경멸,멸시
contemptuous|경멸하는,멸시하는
brutal|잔인한,잔혹한
ruthless|무자비한,인정사정없는
brute|짐승,짐승같은 사람
brutality|잔인함,잔혹성

p.473
savage|야만적인,포악한,몹시 사나운
insane|제정신이 아닌,미친
insanity|정신 이상,미친 짓
frantic|(걱정.공포 등으로)제정신이 아닌,정신없이 서두는
frantically|정신없이
eccentric|괴짜인,별난
hysterical|히스테리의,히스테리성의,이성을 잃은
fuss|호들갑,야단법석
thrifty|절약하는,검소한
stingy|인색한,너무 아끼는
miser|구두쇠
thrift|절약,검소

p.474
overlook|간과하다,못 보고 넘어가다,눈감아 주다,내려다보다
coward|겁쟁이
cowardly|겁이 많은,비겁한
cowardice|겁,비겁
flatter|아첨하다,아부하다,알랑거리다
flattery|아첨,아부
lure|꾀다,유혹하다,유혹,매력,미끼
brag|자랑하다,떠벌리다,자랑,허풍

p.475
old-fashioned|전통적인 사고방식을 지닌,구식의,유행이 지난
hesitant|주저하는
hesitate|주저하다,망설이다
hesitation|주저,망설임
blunt|직설적인,무딘,뭉툭한
settle|정착하다,해결하다,끝내다,결정하다,결심하다,진정시키다,안정시키다
settlement|정착,정착지,해결,합의
settler|정착민