p.306
rational|이성적인,합리적인
causal|원인의,인과관계의
rationality|합리성
rationalize|합리화하다
logic|논리,논리학,타당성
logical|논리적인,타당한
coherent|(생각.주장 등이)일관성 있는,통일성 있는,논리 정연한
cohesion|화합,결합
factual|사실의,사실에 입각한

p.307
empirical|경험에 의거한,실험에 의거한,실증적인
empirically|경험적으로
contemplate|고려하다,심사숙고하다,응시하다
contemplation|사색,명상,응시
ponder|숙고하다,곰곰이 생각하다
meditate|숙고하다,명상하다
meditation|숙고,명상
presume|(사실로)추정하다,여기다
presumption|추정,가정
presumably|아마,생각건대

p.308
quest|탐구,탐색,추구
questionnaire|설문지,질문지
embody|(사상.감정 등을)구현하다,구체적으로 표현하다
mindset|사고방식
cognitive|인지의,인식의
cognition|인지,인식
insight|통찰력,이해,간파
insightful|통찰력 있는

p.309
intuition|직관,직관력,직감
intuitive|직관적인,직감에 의한
viewpoint|견해,관점
perspective|관점,시각,전망,경치,원근법,원근감
outlook|관점,견해,(앞으로의)전망,예측,경치

p.310
preoccupy|생각을 사로잡다,마음을 빼앗다
be preoccupied with|~에 몰두하다
preoccupied|(생각.감정 등에)사로잡힌,정신이 팔린
internalize|(사상.태도 등을)내면화하다,받아들이다
notion|관념,개념,생각
criteria|기준,표준
bias|편견,선입견,편견을 갖게 하다,선입견을 갖게 하다
biased|편견을 가진,치우친

p.311
prejudice|편견,선입견,편견을 갖게 하다,선입견을 갖게 하다
fallacy|(많은 사람이 믿는)그릇된 생각,오류
misconception|(옳지 않은 정보에 근거한)오해,잘못된 생각
obsess|(생각 등이 마음을)사로잡다,집착하게 하다
be obsessed with[by]|~에 집착하다
obsession|강박관념,집착
obsessive|사로잡힌,강박적인
ego자아,자부심,자존심

p.312
ideology|이념,이데올로기
ideological|이념적인,이데올로기적인
mainstream|(사상 등의.강의)주류,대세,주류의,주류에 편입시키다
assimilation|(지식.사상 등을 제 것으로)흡수,동화
pessimism|비관주의,비관론
pessimist|비관주의자
pessimistic|비관적인
realism|현실주의,현실성,사실주의
realist|현실주의자,사실주의 작가,사실주의 화가

p.313
humanitarian|인도주의적인,인도주의자
altruism|이타주의,이타심
altruistic|이타적인
idealism|이상주의
patriotism|애국심
patriot|애국자
patriotic|애국적인,애국심이 강한
humanistic|인본주의적인
liberalism|자유주의,진보주의
liberation|해방,석방
materialism|물질주의,물질만능주의
elitism|엘리트주의,엘리트 의식
elitist|엘리트주의자
nationalism|민족주의,국수주의

p.314
reason|이유,원인,근거,이성,이성적 판단,사리분별,(이성적으로)판단하다,추리하다,추론하다
reasoning|추론,추리
reflect|반사하다,(거울 등에)비치다,반영하다,나타내다,숙고하다,깊이 생각하다
reflection|반사,반향,(거울에 비친)상,모습,(속성 등의)반영,숙고
reflective|(열.빛 등을)반사하는,반영하는,숙고하는,사색적인

p.315
stand|서다,서 있다,~에 있다,위치하다,입장,태도,(특정)입장에 있다,참다,견디다,저항,판매대,매점,(가구 등의)대,스탠드