p.458
stance|입장,태도,자세
apt|~하기 쉬운,~하는 경향이 있는,적절한
be apt to-v|v하기 쉽다,v하는 경향이 있다
temper|(화를 잘 내는)성질,기질,화,(특정한 때의)기분,심정
lose one's temper|화를 내다
temperament|기질,성미
tact|요령,눈치,재치
wit|기지,재치
goodwill|호의,친절,친선

p.459
mercy|자비,인정
at the mercy of|~에 좌우되어,~의 마음대로
merciful|자비로운,인정 많은
benevolent|자비로운,인정 많은
selfless|이타적인,사심 없는
virtue|미덕,선,선행,장점,이점
esteem|존경,존중,존경하다,존중하다
awe|경외심,경외심을 갖게 하다
in awe of|~를 경외하여

p.460
discreet|분별 있는,신중한
discretion|분별,신중
punctual|시간을 엄수하는,기한을 엄수하는
punctuality|시간 엄수
alert|경계하는,방심하지 않는,기민한,(위험 등을)알리다
be alert to|~에 주의를 기울이다
alertness|경계,기민
beware|조심하다,주의하다
prudent|신중한,조심성 있는
watchful|주의 깊은,조심스러운
meticulous|꼼꼼한
wary|경계하는,조심하는

p.461
sophisticated|교양 있는,세련된,지적인,(기계 등이)정교한,복잡한
sophistication|교양,세련됨,(기계 등의)정교함
elegant|우아한,고상한
elegance|우아,고상
grace|우아함,친절,호의,(신의)은총,은혜
graceful|(용모.자태 등이)우아한,품위 있는
gracious|(생활 등이)우아한,품위 있는,정중한,친절한
decent|예의 바른,친절한,(수준.질이)괜찮은,적당한
dignity|위엄,품위
dignify|위엄있어 보이게 하다,품위있어 보이게 하다

p.462
keen|열망하는,간절히 바라는,예리한,날카로운
keen to-v/keen on v-ing|v하기를 간절히 바라는
crave|열망하다,갈망하다
zealous|열심인,열성적인
adventurous|모험심이 강한,흥미진진한
morale|사기,의욕
ambitious|야심 있는,열망하는
ambition|야망,포부

p.463
spontaneous|자발적인,자연히 일어나는,즉흥적인
spontaneously|자발적으로,자연스럽게
spontaneity|자발,자발성,자연스러움
decisive|결단력 있는,단호한,결정적인
sincere|진실한,진심 어린
sincerely|진심으로
sincerity|진실,진심
earnest|진실한,진지한

p.464
integrity|정직,성실,완전한 상태,보전
frank|솔직한
frankly|솔직히,노골적으로
humility|겸손
humble|겸손한,미천한,보잘것없는
modest|겸손한,적당한,수수한
modesty|겸손,적당함,수수함,소박함

p.465
gratitude|감사,고마움
persevere|인내하다,끈기 있게 계속하다
persevere with[in]|~을 인내하며 계속하다
perseverance|인내,인내심,끈기
versatile|다재다능한,(사물이)다용도의,다목적의
feminine|여성의,여성스러운

p.466
regard|주시하다,응시하다,주목,여기다,간주하다,관심,고려,존중,존경,존중하다,존경하다
regard A as B|A를 B로 여기다,A를 B로 간주하다
with[in] regard to|~에 관해
regarding|~에 관하여
dispense|분배하다,나누어 주다,(약을)조제하다,면제하다,없애다
indispensable|없어서는 안 될,필수적인

p.467
tip|(뾰족한)끝,끝 부분,정상,조언,팁,팁을 주다,기울이다,(기울여서)따르다,뒤집어엎다